aaaaaaaaaaaaaaa
XaaXaaaaaXXXXXa
XaXXXXXXXXXXXXa
XaXXXbXXXXXXXXa
aabackupXXXXXXa
aaXXXXXXXXXXXXa
aafuncionandoXa
aaXXXXXXXXXXXXc
aaXXXXXXXXXXXXb
dXXXXXXXXXXXXXd
dXXXXXXXXXXXXXd
dXXXXXXXXXXXXXd
dXXXXXXXXXXXXXd
XXXXXXXXXXXXXXd
ddddddddddddddd